
R 1280 720


F 89,89,89
F 68,206,235

11111111111111111111111
10000000000000000000001
10000000000000000000001
10000000000000000000001
10000000020002020000001
10000W10000000000000001
10000000000000000000001
10000000000000000000001
10000000000000000000001
11111111111111111111111