
R             1280 720
NO       ./textures/eagle.xpm
SO ./textures/mossy.xpm
WE ./textures/greystone.xpm
EA ./textures/bluestone.xpm

S ./textures/barrel.xpm
F 89,89,89
C 68,206,235

111111111111111111111
100000000000000000001
100000000000000000001
100000000000000000001
100000000202020000001
10000N000000000000001
100000000000000000001
100000000000000000001
111111111111111111111