
R 1280 720

NO ./textures/purplestone.xpm
SO ./textures/redbrick.xpm
WE ./textures/eagle.xpm
EA ./textures/wood.xpm

S ./textures/barrel.xpm
F 89,89,89
C 68,206,235

11111111111111111111111
10000000000000000000001
10000000000000000000001
10000000000000000000001
10000000020002020000001
10000010000000000000001
100000000000N0000000001
10000000000000000000001
10000000000000000000001
11111111111111111111111