
 R 1280 720

NO ./textures/l1.xpm
SO ./textures/l2.xpm
WE ./textures/l3.xpm
EA ./textures/l4.xpm

S ./textures/lteemo.xpm
F 188,200,92
C 100,255,235

11111111111111111111111111111
10000000000000000000000000001
10000000000000000000000000001
10000000000000000000000000001
10000000000000000000000000001
10000000002020200000000000001
10000000000000000000000000001
10000000000000000000000000001
10000000000000000000000000001
10000100000000000000000000001
100001000000N0000000000000001
10000100000000000000000000001
10000100000000000000000000001
11111111111111111111111111111