R 1200 720

 NO ./textures/xok1.xpm
   SO ./textures/xok2.xpm
 WE ./textures/xok3.xpm
         EA ./textures/xok4.xpm

  S ./textures/xok5.xpm
    F 188,200,92
        C 100,255,235

11111111111111
10000000000001
10000000000001
10000000000001
10000202020001
10000000000001
1000000N000001
10000000000001
11111111111111

