 R 1280 720

NO ./textures/zbrick.xpm
SO ./textures/zbox.xpm
WE ./textures/zwood.xpm
EA ./textures/zstone.xpm

S ./textures/zboko.xpm
F 188,136,92
C 68,206,235

1111111111111111111111111111111111111111111
1000000000000000000000000000000000000000001
1000000000000000000000000000000000000000001
1000000000000000000000000000000000000000001
1000000000000000000000000000000000000000001
1000000000000000000000010100000000000000001
1000000000000000000000010100000000000000001
1000000000000000000000010100000000000000001
1000000000000000000000010100000000000000001
1000000000000000000000010100000000000000001
100000000000N000000000010100000000000000001
1000000000000000000000010100000000000000001
1110110000000000000000010100000000000000001
1000210000000000000000010100000000000000001
1202010000000000000000010100000000000000001
1020210000000000000000010100000000000000001
1202010000000000000000010100000000000000001
1020210000000000000000010100000000000000001
1111111111111111111111111111111111111111111